Game: Sokoban
Collection: Second Epoch
Author: Matt Pullin
Copyright: Copyright 2012 Second Epoch Solutions
Original website: http://secondepoch.com

Opening

##############
#        ....#
#$# ######.#*#
#            #
#*#$$$$$$$$#*#
# *        * #
# ##    @ ## #
#  ##    ##  #
#.  ##**##  .#
#.          .#
##############

Artery Clogger

######   #######
#.   # ##########
# ** ###     #  ##
# *. ... #$ $ $ @#
#  ..###   $ $# ##
###.#####  $ $   #
  #.#   ##  $  # #
###.###### # #.###
# $$    ###  #.#
# $ $#$ # ####.##
#  #    ## ###  #
# $ $ $  ###. $ #
#    #   ... .* #
# $#$ $  ###.** #
##     ### #   .#
 #######   ######

Cabbage

#############
#     #     #
#  $#$#$#$# #
# $$  .     #
##.#.# #.*. #
 #    .     #
 ### ### ####
   #  @  #
   #######

Hirame

#####
#   #######
# $ ##....#
# #$#..*..#
# $ $ $#$ #
#     $@$ #
#  #  #   #
###########

Amino Acid

#########
#   @   #
# $ $$$ #
# $ $ $ #
##.#.#.##
#  . $  #
##.#.#.##
#  .    #
#########

Dolce Sheep

 ##############
##   ####     #
#@     ##  $  #
## # $  . $## #
 #.## ####  # #
 #### #  #  # #
 # $    $   # #
 #  #$## # ## ##
##         # $.#
#   ###   #   .#
# .....#$#    ##
#  #     #   ##
####   #$   ##
   #####   ##
       #####

Mule

##########
#    .   #
#  # *.$ #
# #  #####   #
#   $@#     #
#  #  ######
#### $   . #
   # $ $ *.#
   #  ###. #
   #### ####

Carbunkl

 ##########
#...       ###
#...## $ #$ $ #
#..###@#    # #
#  #  #  $#   #
#$     ##  # #
#   # $  $   #
### #  ## ## #
# $ ####  #   #
# #      ## # #
# ########    #
#          ###
 ##########
 
Snail

 ############
##  ##      #
# @  # #$$# #
#    #   $  #
##   ##  #  #
 ##$ $      #
 #  #$$##$#####
 # $ $    .....#
 #     #  .....#
  #############

Circular Latch

########
#     @#
#  #  .#
#$ #.$.#
# . $#$#
# #$ . #
# $.# $#
#.     #
########
